Xu, Xu, Xu, Xu, Xu, Xu, Xu, Xu, Xu, Xu, Xu, Xu, Xu, Xu, Xu, Xu, Xu, Xu, Xu, Xu, Xu, Gg, Xu, Xu, Xu, Xu, Xu, Xu, Xu, Xu, Xoa^Efs, Ur^Ii, Ur^Ii, Xos^Efs, Xu, Xu, Xu, Xu
Xu, Xu, Xu, Xu, Xu, Xu, Xu, Xu, Xu, Xu, Xu, Xu, Xu, Xu, Xu, Xu, Xu, Xu, Xu, Xu, Xu, Xu, Xu, Xu, Xu, Xu, Xu, Xu, Xu, Xoa^Efs, Ur, Ur^Ii, Xoa^Efs, Xoa, Xu, Xu, Xu, Xu
Xu, Xu, Xu, Xu, Xu, Xu, Xu, Xu, Xu, Xu, Xu, Xu, Xu, Xu, Xu, Xu, Xu, Xu, Xu, Xu, Xu, Xu, Xu, Xu, Qxua, Qxua, Aa, Aa, Aa, Ur, Aa, Xos, Aa, Qxua, Qxua, Xu, Xu, Xu
Xu, Xu, Xu, Xu, Xu, Xu, Xu, Xu, Xu, Xu, Xu, Xu, Xu, Xu, Xu, Xu, Xu, Xu, Xu, Xu, Xu, Xu, Xu, Xu, Qxua, Aa, Aa, Aa^Fetd, Aa, Rrc, Rrc, Aa, Aa^Vwm, Ai, Qxua, Xu, Xu, Xu
Xu, Xu, Xu, Xu, Xu, Xu, Xu, Xu, Xu, Xu, Xu, Xu, Xu, Xu, Xu, Xu, Xu, Xu, Xu, Xu, Xu, Xu, Qxua, Qxua, Ai^Esa, Aa, Rrc^Vhca, Rrc, Rrc, Aa, Rrc, Aa, Rrc, Aa, Aa, Qxua, Xu, Xu
Xu, Xu, Xu, Xu, Xu, Xu, Xu, Xu, Xu, Xu, Xu, Xu, Xu, Xu, Xu, Xu, Xu, Xu, Xu, Xu, Xu, Wwg, Wwg, Wwg^Esa, Dd, Aa, Aa, Aa, Aa, Kha, 2 Kha, Rrc, Aa, Aa^Emf, Aa, Qxua, Qxua, Xu
Xu, Xu, Xu, Xu, Xu, Xu, Xu, Xu, Xu, Xu, Xu, Xu, Xu, Xu, Xu, Xu, Xu, Xu, Xu, Xu, Qxua, Wwf, Uu, Dd, Dd^Esa, Aa, Dd^Edp, Gg, Qxu^Bp/, Qxu^Bp/, Qxua, Kha, Rrc, Aa, Rrc^Vhca, Aa, Xu, Xu
Xu, Xu, Xu, Xu, Xu, Xu, Xu, Xu, Xu, Xu, Xu, Xu, Xu, Xu, Xu, Xu, Xu, Xu, Xu, Qxua, Wwf, Wwf, Ur, Dd, Dd^Vda, Gs^Esa, Gs, Gg, Qxua, Qxua, Qxua, Aa, Aa, Rrc, Aa^Emf, Aa, Xu, Xu
Xu, Xu, Xu, Xu, Xu, Xu, Xu, Xu, Xu, Xu, Xu, Xu, Xu, Xu, Xu, Xu, Xu, Xu, Uue, Qxua, Wwf, Wwg, Qxua, Dd, Hd, Hd, Dd^Edp, Gg, Dd^Do, Qxua, Gg, Aa, Aa, Aa, Aa, Aa, Xu, Xu
Xu, Xu, Xu, Xu, Xu, Xu, Xu, Xu, Xu, Xu, Xu, Xu, Xu, Xu, Xu, Xu, Xu, Uue, Wwg, Qxua, Ur, Uu, Qxua, Qxua, Dd, Dd, Dd^Edp, Dd^Edp, Gs, Gg, Dd^Edp, Gg^Esa, Hd, Dd^Esa, Aa, Qxua, Xu, Xu
Xu, Xu, Xu, Xu, Xu, Xu, Xu, Xu, Xu, Xu, Xu, Xu, Xu, Xu, Xu, Xu, Xu, Xu, Wwg, Uue, Ur, Uu^Vud, Uue, Wwg, Wwf, Dd, Dd, Gd^Ecf, Hd, Dd^Edp, Dd^Edp, Gs, Dd^Vdt, Hd, Qxua, Qxua, Xu, Xu
Xu, Xu, Xu, Xu, Xu, Xu, Xu, Xu, Xu, Xu, Xu, Xu, Xu, Xu, Xu, Xu, Xu, Xoa, Uue, Wwg, Ur, Uue, Wwg, Wwg, Uue, Dd, Dd, Dd, Hd, Dd, Dd, Dd, Dd, Dd, Uu^Vud, Xu, Xu, Xu
Xu, Xu, Xu, Xu, Xu, Xu, Xu, Xu, Xu, Xu, Xu, Xu, Xu, Xu, Xu, Xu, Xoa, Xoa, Ur, Wwg, Wwf, Wwg, Qxua, Qxua, Uue, Uue, Uue, Dd, Qxua, Dd, Wwf, Dd, Uu, Uu, Qxua, Xu, Xu, Xu
Xu, Xu, Xu, Xu, Xu, Xu, Xu, Xu, Xu, Xu, Xu, Xu, Xu, Xu, Xu, Xu, Uue, Uh, Sm, Ur, Xoa, Wwg, Wwg, Qxua, Qxua, Uue, Uu^Vud, Qxua, Qxua, Qxua, Wwf, Wwf, Wwg, Qxua, Qxua, Xu, Xu, Xu
Xu, Xu, Xu, Xu, Xu, Xu, Xu, Xu, Xu, Xu, Xu, Xu, Xu, Xu, Uue, Sm^Emf, Sm, Sm, Ur, Ur, Sm, Ur, Ur, Wwg, Qxua^Br|, Qxua^Br/, Qxua, Uue, Uue, Wwg, Uue, Ur, Uu, Wwg, Qxua, Qxua, Xu, Xu
Xu, Xu, Xu, Xu, Xu, Xu, Xu, Xu, Xu, Xu, Xu, Xu, Xu, Xu, Sm, Sm, Sm, Wwf, Sm, Sm, Sm, Sm, Sm, Cud, 3 Kud, Qxua, Ur, Ur, Wwg, Wwf, Ur, Ur, Ur, Wwg, Wwf, Wwf, Xu, Xu
Xu, Xu, Xu, Xu, Xu, Xu, Xu, Xu, Xu, Xu, Xu, Xu, Uh, Uue, Sm^Emf, Sm, Sm, Ur, Uu^Vud, Sm^Emf, Sm, Sm^Emf, Sm, Cud, Cud, Cud, Wwf, Wwg, Ur, Ur, Uu, Uue, Uu, Ur, Uh, Xu, Xu, Xu
Mm^Xm, Xu, Xu, Xu, Xu, Xu, Xu, Xu, Xu, Xu, Xu, Uu^Tf, Uue, Uh^Vud, Sm, Sm, Sm, Ur, Sm, Sm, Uue, Sm, Wwg, Wwg, Wwg^Br|, Wwg, Ww, Ur, Xoa, Uh, Uu, Uu^Tf, Uue, Uue, Xu, Xu, Xu, Xu
Mm^Xm, Mm^Xm, Mm, Xu, Xu, Xu, Xu, Xu, Xu, Xu, Xuc, Sm, Sm, Sm, Sm, Sm, Wwf, Wwf, Uue, Xu, Xuc^Efs, Xuc, Wwg, Wwf^Br/, Wwf, Ww, Dd, Ur, Uh, Ur, Ur, Uue, Xoa, Xoa, Xu, Xu, Xu, Xu
Mm, Mm, Mm, Xu, Mm, Xu, Xu, Xu, Xuc, Xuc, Uu, Uh, Sm, Sm^Emf, Sm, Sm, Sm^Emf, Ur, Xuc, Xuc^Efs, Wwf^Ii, Wwg^Ii, Uue, Xuc, Wwf, Dd^Dr, Dd^Ii, Ww, Ww, Sm^Emf, Uh, Xoa, Xu, Xu, Xu, Xu, Xu, Xu
Mm, Mm, Mm, Mm, Mm, Xu, Xu, Xu, Xuc, Uu, Uh, Uu, Sm, Sm, Sm, Sm, Wwf, Ur, Uu^Br|, Wwf^Br/, Uue, Uue, Xu, Xu, Wwf, Dd, Dd^Do, Dd^Ii, Dd, Wwg, Uue, Xoa, Xu, Xu, Xu, Xu, Xu, Xu
Hh, Mm, Mm, Mm, Mm, Xu, Xu, Xu, Xu, Uh, Sm^Emf, Sm, Sm, Sm, Ur, Ur, Sm, Ur, Uu^Br|, Xuc, Xuc, Xuc, Uu^Vud, Wwg, Ur, Dd, Ww^Ii, Dd^Ii, Dd^Dr, Wwg, Uue, Xu, Xu, Xu, Xu, Xu, Xu, Xu
Hh^Fp, Mm^Fp, Mm, Mm, Mm, Mm, Mm, Xu, Xu, Xu, Uu, Uu, Sm, Ur, Uh, Sm, Uh, Wwf, Wwf, Xu, Sm, Sm, Uh, Wwg, Ur, Dd, Ww, Dd, Wwg, Wwg, Uu^Vud, Xu, Xu, Xos, Xu, Xu, Xu, Xu
Hh^Fp, Hh^Fp, Hh^Fp, Mm^Fp, Mm^Fp, Mm, Mm, Xu, Xu, Xu, Xu, Uh, Rb, Wwf, Rb, Uh, Uu, Ur, Uu^Br|, Sm, Sm, Sm, Uu, Ur, Uh, Xu, Xu, Wwg, Xuc, Wwf, Uue, Xu, Xu, Xu, Xu, Xu, Xu, Xu
Hh^Fp, Hh^Fp, Hh^Fp, Mm, Mm, Mm, Mm, Mm, Gg^Em, Xu, Xof, Rb^Emf, Gg^Em, Rb, Rb, Rb, Uu, Ur, Wwf, Sm, Uu, Sm, Wwf, Ur, Uu, Xu, Xu, Xu, Wwf, Wwf, Xu, Xu, Xu, Xu, Xu, Xu, Xu, Xu
Gll^Fmf, Hh^Fp, Hh^Fp, Hh^Fp, Hh^Fp, Mm, Mm, Mm, Gg, Gg, Mm, Re, Re, Rb, Gg^Em, Rb, Rb, Rb, Cfr, Ur, Ur, Ur, Uh, Wwf, Wwf, Uh, Xuc, Xu, Wwf, Xu, Xu, Xu, Xu, Xu, Xu, Xu, Xu, Xu
Gll^Fdf, Gll^Fmf, Gll^Fmf, Hh^Fp, Hh^Fp, Mm^Fp, Mm, Mm, Mm, Mm, Mm, Mm, Gg^Em, Xof, Re, Gg^Em, Cfr, Cfr, 1 Kfr, Cfr, Rb, Uu, Ur, Ur, Wwf, Ur, Wwf, Wwf, Xu, Xu, Xu, Xu, Xu, Xu, Xu, Xu, Xu, Xu
Gll^Fdf, Gll^Fmf, Gll^Fmf, Hh^Fp, Hh^Fp, Hh, Hh^Fp, Mm^Fp, Mm, Mm, Mm, Mm, Mm, Gg, Gg^Em, Re, Cfr, Rb, Rb, Cfr, Rb, Ur, Uu, Uh, Wwf, Wwf, Uu^Tf, Xu, Xu, Xu, Xu, Xu, Xu, Xu, Xu, Xu, Xu, Xu
Gll^Fdf, Gll^Fmf, Gll^Fmf, Gll^Fmf, Hh^Fp, Hh^Fp, Hh^Fmf, Hh^Fp, Hh^Fp, Hh^Fp, Hh, Mm, Hh, Gg, Mm, Gg, Gg, Cfr, Cfr, Cfr, Gg^Em, Rb, Rb, Rb, Uu, Uu, Xuc, Xu, Xu, Xu, Xu, Xu, Xu, Xu, Xu, Xu, Xu, Xu
Gll^Fmf, Gll^Fmf, Gll^Fmf, Gll^Fmf, Gll^Fmf, Gll^Fmf, Gll^Fmf, Hh^Fp, Hh^Fp, Hh, Hh^Fp, Hh, Hh^Fp, Hh, Hh, Mm, Gg, Gg^Em, Gg, Re, Re, Rb, Gg^Em, Rb, Rb, Uu, Xuc, Xu, Xu, Xu, Xu, Xu, Xu, Xu, Xu, Xu, Xu, Xu
Gll^Fmf, Gll^Fmf, Gll^Fmf, Gll^Fmf, Gll^Fmf, Gll^Fmf, Gll^Fmf, Gll^Fdf, Gll^Fmf, Gll^Fmf, Gll^Fmf, Hh^Fp, Gll^Fp, Hh, Hh, Mm, Mm, Mm, Mm, Gg, Gg, Xof, Re, Gg^Em, Rb, Uu, Uh, Xuc, Xu, Xu, Xu, Xu, Xu, Xu, Xu, Xu, Xu, Xu
Gll^Fmf, Gll^Fmf, Gll^Fmf, Gll^Fmf, Gll^Fdf, Gll^Fmf, Gll^Fmf, Gll^Fmf, Gll^Fdf, Gll^Fmf, Gll^Fmf, Gll^Fp, Gll^Fmf, Hh, Hh^Fp, Hh, Hh, Mm, Mm, Mm, Mm, Mm, Gg, Re, Xof, Uu, Xoa, Xoa, Xu, Xu, Xu, Xu, Xu, Xu, Xu, Xu, Xu, Xu
Gll^Fmf, Gll^Fmf, Gll^Fdf, Gll^Fdf, Gll^Fdf, Gll^Fdf, Gll^Fmf, Gll^Fmf, Gll^Fmf, Gll^Fmf, Gll^Fmf, Gll^Fmf, Gll^Fmf, Gll^Fmf, Gll^Fmf, Gll^Fp, Hh^Fp, Hh, Hh, Hh, Mm, Mm, Mm, Mm, Gg, Xof, Xof, Xu, Xu, Xu, Xu, Xu, Xu, Xu, Xu, Xu, Xu, Xu
Gll^Fmf, Gll^Fdf, Gll^Fdf, Gll^Fdf, Gll^Fmf, Gll^Fmf, Gll^Fmf, Gll^Fmf, Gll^Fdf, Gll^Fdf, Gll^Fdf, Gll^Fdf, Gll^Fmf, Gll^Fmf, Gll^Fmf, Gll^Fmf, Hh^Fp, Hh, Hh^Fp, Hh, Hh^Fp, Mm, Mm^Fp, Mm, Mm, Gg, Mm, Xu, Xu, Xu, Xu, Xu, Xu, Xu, Xu, Xu, Xu, Xu
Gll^Fdf, Gll^Fdf, Gll^Fdf, Gll^Fdf, Gll^Fmf, Gll^Fmf, Gll^Fdf, Gll^Fdf, Gll^Fmf, Gll^Fdf, Gll^Fdf, Gll^Fdf, Gll^Fdf, Gll^Fmf, Gll^Fmf, Gll^Fdf, Gll^Fmf, Hh^Fp, Hh, Hh, Hh, Hh^Fp, Mm, Mm, Mm, Mm, Xu, Xu, Xu, Xu, Xu, Xu, Xu, Xu, Xu, Xu, Xu, Xu
Gll^Fdf, Gll^Fdf, Gll^Fmf, Gll^Fdf, Gll^Fmf, Gll^Fmf, Gll^Fmf, Gll^Fmf, Gll^Fdf, Gll^Fdf, Gll^Fdf, Gll^Fdf, Gll^Fdf, Gll^Fmf, Gll^Fmf, Gll^Fmf, Gll^Fmf, Gll^Fmf, Gll^Fmf, Hh^Fp, Hh^Fp, Hh^Fp, Mm^Fp, Mm, Mm, Xu, Xu, Xu, Xu, Xu, Xu, Xu, Xu, Xu, Xu, Xu, Xu, Xu
Gll^Fmf, Gll^Fmf, Gll^Fmf, Gll^Fdf, Gll^Fmf, Gll^Fmf, Gll^Fmf, Gll^Fmf, Gll^Fmf, Gll^Fmf, Gll^Fdf, Gll^Fdf, Gll^Fmf, Gll^Fmf, Gll^Fdf, Gll^Fmf, Gll^Fmf, Gll^Fdf, Gll^Fdf, Hh^Fp, Mm, Mm, Mm, Mm, Mm, Xu, Xu, Xu, Xu, Xu, Xu, Xu, Xu, Xu, Xu, Xu, Xu, Xu
Gll^Fdf, Gll^Fmf, Gll^Fdf, Gll^Fdf, Gll^Fdf, Gll^Fdf, Gll^Fdf, Gll^Fdf, Gll^Fmf, Gll^Fmf, Gll^Fmf, Gll^Fmf, Gll^Fmf, Gll^Fmf, Gll^Fdf, Gll^Fdf, Gll^Fmf, Gll^Fmf, Hh^Fp, Hh^Fp, Mm, Mm, Mm, Mm, Mm, Mm, Xu, Xu, Xu, Xu, Xu, Xu, Xu, Xu, Xu, Xu, Xu, Xu
Gll^Fdf, Gll^Fdf, Gll^Fdf, Gll^Fdf, Gll^Fdf, Gll^Fdf, Gll^Fdf, Gll^Fdf, Gll^Fdf, Gll^Fmf, Gll^Fdf, Gll^Fmf, Gll^Fmf, Gll^Fmf, Gll^Fdf, Gll^Fmf, Gll^Fmf, Gll^Fmf, Hh^Fp, Hh, Hh, Mm, Mm, Mm, Mm, Mm, Mm, Xu, Xu, Xu, Xu, Xu, Xu, Xu, Xu, Xu, Xu, Xu
Gll^Fdf, Gll^Fdf, Gll^Fdf, Gll^Fdf, Gll^Fmf, Gll^Fdf, Gll^Fdf, Gll^Fdf, Gll^Fmf, Gll^Fdf, Gll^Fdf, Gll^Fdf, Gll^Fmf, Gll^Fmf, Gll^Fdf, Gll^Fmf, Gll^Fmf, Gll^Fdf, Gll^Fmf, Hh^Fp, Hh^Fp, Mm, Mm, Mm, Md, Mm, Mm, Mm, Xu, Xu, Xu, Xu, Xu, Xu, Xu, Xu, Xu, Xu
Gll^Fmf, Gll^Fdf, Gll^Fdf, Gll^Fmf, Gll^Fmf, Gll^Fdf, Gll^Fdf, Gll^Fdf, Gll^Fdf, Gll^Fmf, Gll^Fmf, Gll^Fmf, Gll^Fmf, Gll^Fmf, Gll^Fmf, Gll^Fmf, Gll^Fmf, Gll^Fmf, Gll^Fmf, Hh^Fp, Hh, Mm, Hh, Hh, Hh, Mm, Mm, Mm^Xm, Mm^Xm, Xu, Xu, Xu, Xu, Xu, Xu, Xu, Xu, Xu
Gll^Fmf, Gll^Fmf, Gll^Fdf, Gll^Fmf, Gll^Fmf, Gll^Fdf, Gll^Fdf, Gll^Fdf, Gll^Fdf, Gll^Fmf, Gll^Fmf, Gll^Fmf, Gll^Fmf, Gll^Fmf, Gll^Fdf, Gll^Fdf, Gll^Fmf, Gll^Fmf, Gll^Fmf, Hh, Hh, Hh, Hh^Fp, Hh, Hh, Hh, Hh, Mm^Xm, Mm^Xm, Mm^Xm, Mm^Xm, Xu, Xu, Xu, Xu, Xu, Xu, Xu
