Gs^Fds, Gs^Fds, Gll^Fms, Gs^Fds, Gll^Fds, Gg, Gll^Fds, Gll^Fds, Gll^Fds, Gll^Fds, Gs^Fds, Gll^Fds, Gll^Fms, Gll^Fds, Gll^Fds, Gll^Fds, Gs^Fds, Hh^Fds, Hh^Fds, Hh^Fds, Hh, Hh, Hh, Mm, Ww, Mm, Mm, Mm, Mm, Mm, Mm, Mm, Hh, Mm, Mm, Hh, Hh, Gg, Mm, Mm, Mm
Gs^Fds, Gll^Fms, Gs^Fms, Gll^Fds, Gll^Fds, Gg^Vh, Gll^Fds, Gll^Fds, Gll^Fds, Gll^Fms, Gs^Fms, Gs^Fms, Gs^Fds, Gs^Fds, Gll^Fds, Gs^Fds, Gll^Fds, Hh^Fds, Hh^Fds, Hh^Fds, Hh, Hh, Hh, Mm, Ww, Mm^Vhh, Mm, Mm, Mm, Mm, Mm, Mm, Hh, Mm, Mm, Hh, Hh, Gg, Mm, Mm, Mm
Gs^Fds, Gs^Fms, Gs^Fp, Gs^Fp, Gs^Fds, Gll^Fds, Gll^Fds, Gll^Fds, Gg^Vl, Gll^Fds, Gll^Fds, Gll^Fds, Gll^Fds, Gll^Fds, Gll^Fds, Gll^Vh, Gll^Fds, Gll^Fds, Gll, Gg, Gg^Vl, Hh, Hh, Ww, Mm, Mm, Hh, Mm, Mm, Mm, Hh, Hh, Hh, Mm, Mm, Hh, Mm, Mm^Vhh, Mm, Mm, Mm
Gs^Fds, Gs^Fds, Gll^Fds, Gs^Fds, Gs^Fds, Gs^Fds, Gs^Fds, Gll^Fds, Gll^Fds, Gll^Fds, Gll^Fds, Gll^Fds, Gll^Fds, Gll^Fds, Ww, Ww, Ww, Hh, Ww, Ww, Ww, Gg, Ww, Ww, Hh, Mm, Gg, Hh, Gg, Hh, Gd^Es, Gs, Gg, Hh, Hh, Hh, Mm, Mm, Mm, Mm, Mm
Gll^Fds, Gs^Fds, Gs^Vh, Gs^Fds, Gll^Fds, Gs^Fds, Gll^Fds, Gll^Em, Gg, Gg, Gll, Gll, Gll, Ww, Gll^Fds, Gll^Fds, Hh^Fds, Ww, Gg, Hh, Hh, Ww, Hh, Hh, Gg, Hh, Hh, Gs, Cer, Gg, Gg, Gs, Gd, Hh, Hh, Hh, Hh, Hh, Mm, Mm, Mm
Gll^Fds, Gs^Fds, Gs^Fds, Gs^Fds, Gs^Fds, Gll^Fds, Gll, Gg, Gll^Fds, Gg, Gg, Gll^Fds, Ww, Ww, Gg, Gg, Hh, Gg, Gg, Hh, Gd, Gg, Hh, Gg^Vhh, Gg, Gs, Gd, Cer, 2 Ker, Cer, Gg, Gg^Vh, Gd, Gs, Hh, Hh, Hh, Hh, Mm, Mm, Mm
Gll^Fds, Gs^Fds, Gs^Fms, Gll^Fms, Gll^Fds, Gll^Fds, Gll^Fds, Gll, Gg, Gg, Ww, Ww, Gg^Efm, Gg^Efm, Gg, Hh, Gg, Gg, Gg, Gs, Hh, Gg, Hh, Hh, Hh, Gs, Gg, Cer, Cer, Cer, Gs, Gg, Gs, Hh, Hh, Hh, Mm, Mm, Mm, Mm, Mm
Gll^Fds, Gs^Fds, Gll^Fds, Gll^Fds, Gll, Gg, Gll, Gll, Gll^Fds, Ww, Ww, Hh, Gg, Gs^Efm, Gs, Gg, Re^Gvs, Re^Gvs, Gg, Hh, Hh, Gs, Gg, Hh, Hh, Hh, Gg, Gs, Gs, Gg, Gs, Hh, Hh, Hh, Hh, Hh^Vhh, Mm, Mm, Mm, Mm, Mm
Gll^Fds, Gs^Fds, Gs^Fds, Gll^Fds, Gll^Fds, Gll^Fds, Gll^Fds, Gll, Gg, Gg, Gll, Ww, Gg, Gs, Re^Gvs, Re^Gvs, Re^Gvs, Gg, Re^Gvs, Gg, Gg, Gs, Gd, Hh, Hh, Mm, Mm, Hh, Hh, Hh, Mm, Mm, Mm, Hh, Hh, Mm, Mm, Mm, Mm, Mm, Mm
Gll^Fds, Gs^Fms, Gs^Fms, Gll^Fds, Gll^Fds, Gll^Fds, Gll^Fds, Gll^Fds, Gs, Gs, Gll^Fds, Ww, Gg, Gs, Re^Gvs, Re^Gvs, Re^Gvs, Re^Gvs, Re^Gvs, Gg^Vc, Re^Gvs, Gg, Gg, Hh, Hh, Mm, Mm, Mm, Hh, Mm, Mm, Mm, Mm, Mm, Hh, Hh, Mm, Mm, Mm, Mm, Mm
Gll^Fds, Gll^Fms, Gs^Fds, Gs^Fds, Gll^Fds, Gll^Em, Gg, Gs, Gs, Gll, Ww, Ww, Ww, Gg, Re^Gvs, Re^Gvs, Re^Gvs, Re^Gvs, Re^Gvs, Re^Gvs, Gg, Gll^Fms, Gll, Gg, Gg, Hh, Mm, Mm, Hh, Hh, Hh, Mm, Mm, Hh, Hh, Mm, Mm, Mm, Mm, Mm, Mm
Gll^Fds, Gll^Fds, Gll^Fds, Gll^Fds, Gll^Fds, Gll^Fds, Re^Gvs, Gs, Ww, Ww, Gg, Ww, Gg, Gg, Re^Gvs, Re^Gvs, Re^Gvs, Re^Gvs, Re^Gvs, Gg, Gg, Gll^Fds, Gs^Fms, Gg, Gg, Gg^Vh, Hh, Hh, Gd^Es, Gg, Gg, Hh, Gg, Hh, Gs, Hh, Hh, Mm, Mm, Mm, Mm
Gll^Fds, Gll^Fds, Gll^Fds, Gll^Fds, Re^Gvs, Re^Gvs, Gg, Gs^Fds, Ww, Hh, Re, Gg, Re^Gvs, Re^Gvs, Re^Gvs, Re^Gvs, Re^Gvs, Re^Gvs, Re^Gvs, Re^Gvs, Re^Gvs, Gll, Gll^Fms, Gll^Fms, Gg, Hh, Hh, Gg, Gs, Gs, Cer, Gg^Vl, Gg, Gs, Hh, Gs, Gd, Hh, Hh, Mm, Mm
Gg, Gll^Em, Re^Gvs, Re^Gvs, Re^Vl, Re^Gvs, Gg, Ww, Re^Gvs, Re^Gvs, Re^Gvs, Gg^Vh, Re^Gvs, Re^Gvs, Re^Gvs, Re^Gvs, Re^Gvs, Re^Gvs, Rr, Gs, Gg, Gg, Gll, Gll, Gg, Hh, Hh, Gs, Gs, Cer, 3 Ker, Cer, Gg, Gs^Ecf, Hh, Gd, Hh, Hh, Gs, Hh, Hh
Rr, Rr, Rr, Rr, Rr, Re^Gvs, Rr, Ww, Gg, Re^Gvs, Re^Gvs, Re^Gvs, Gg, Re^Gvs, Re^Gvs, Re^Gvs, Gg, Rr, Gg, Rr, Gll, Gg, Gg^Vh, Rr, Rr, Hh, Gg, Gg, Gg, Cer, Cer, Cer, Gd, Gs, Re, Gs, Hh, Hh, Hh, Gd, Gs
Gll, Gg, Re^Gvs, Re^Gvs, Gll^Fds, Rr, Gll^Fds, Ww^Bw\, Rr, Re^Gvs, Ch, Ch, Ch, Gg, Rr, Rr, Gg^Vh, Gg, Re^Gvs, Gg, Gs^Fds, Gll^Fms, Gll, Gg, Gg, Gg, Hh, Rr, Re, Gg, Gs, Gg, Re, Gd, Gg^Vhh, Re, Gs^Es, Re, Re, Re, Re
Gll^Fds, Gll^Fds, Gll^Fds, Re^Gvs, Gll^Fds, Gll^Fds, Gs^Fds, Ww, Gg, Rr, Ch, 1 Kh, Ch, Gs, Rr, Gg, Re^Gvs, Re^Gvs, Gll^Fds, Gg, Gll^Fds, Gs^Fms, Gll^Fms, Gll^Fms, Gll^Fms, Gg, Hh, Hh, Hh, Hh, Gs, Re, Gg, Hh, Hh, Hh, Gs, Hh, Hh, Hh, Hh
Gll^Fds, Gll^Fds, Gs^Fds, Gll^Fds, Gll^Fds, Gll^Fds, Gll, Ww, Gg^Efm, Rr, Rr, Ch, Rr, Rr, Re^Gvs, Gg, Re^Gvs, Re^Gvs, Re^Gvs, Gg, Gg, Gll, Gll, Gg, Hh, Gg, Gg, Hh, Hh, Hh, Hh, Gg^Vh, Hh, Hh, Hh, Hh, Hh, Hh, Mm, Mm, Mm
Gll^Fds, Gs^Fp, Gs^Fp, Gll^Fds, Gll^Fds, Gll^Fds, Ww, Ww, Gg^Efm, Gs^Efm, Gs, Gg, Re^Gvs, Re^Gvs, Re^Gvs, Re^Gvs, Re^Gvs, Re^Gvs, Gg, Gll, Gll, Gll^Fds, Gll^Fds, Gll, Hh^Fms, Gg, Hh, Hh, Mm, Mm, Hh, Hh, Hh, Mm, Hh, Mm, Mm, Mm, Mm, Mm, Mm
Gll^Fds, Gll^Fds, Gll^Fms, Gll^Fds, Gll^Fds, Ww, Gg^Vh, Gg, Gg, Gs, Re^Gvs, Re^Gvs, Re^Gvs, Re^Gvs, Re^Gvs, Re^Gvs, Re^Gvs, Re^Vwm, Re^Gvs, Gll^Fds, Gll^Fds, Gs^Fms, Gs^Fms, Gll^Fms, Gll^Fds, Gg, Hh, Mm, Hh, Mm, Mm, Mm, Mm, Mm, Mm, Hh, Mm, Mm, Mm, Mm, Mm
Gll^Fds, Gll^Fds, Gll^Fds, Gll^Fds, Gll^Fds, Ww, Ww, Gg, Gll^Fds, Re^Gvs, Re^Gvs, Re^Gvs, Re^Gvs, Re^Gvs, Re^Gvs, Re^Gvs, Re^Gvs, Re^Gvs, Gll, Gll, Gll^Fds, Gll^Fms, Gll^Fds, Gll^Fms, Gll^Fms, Gll, Gg, Gg, Gg, Hh, Hh, Hh, Mm, Mm, Mm, Mm, Mm, Mm, Mm, Mm, Mm
Gll^Fds, Gll^Fms, Gll^Fds, Gg^Vh, Gll^Fds, Gll^Fds, Ww, Gg, Gg, Re^Gvs, Re^Gvs, Re^Gvs, Re^Vh, Re^Gvs, Re^Gvs, Re^Gvs, Re^Gvs, Gg, Re^Gvs, Re^Gvs, Re^Gvs, Gll, Gll, Gg^Em, Gll^Fms, Gll^Fds, Hh, Gg, Hh, Hh, Mm, Mm, Mm, Mm, Mm, Mm, Mm, Mm, Mm, Mm, Mm
Gs^Fds, Gll^Fds, Gll^Fds, Gll^Fds, Gll^Fds, Gll^Fds, Gll^Fds, Ww, Gg, Re^Gvs, Re^Gvs, Re^Gvs, Re^Gvs, Re^Gvs, Re^Gvs, Re^Gvs, Re^Gvs, Re^Gvs, Re^Gvs, Re^Gvs, Re^Gvs, Re^Gvs, Re^Gvs, Gs, Gs, Hh^Fms, Gg, Gg, Hh, Mm, Mm, Hh, Gg^Vl, Gs, Mm, Mm, Gg^Vh, Mm, Mm, Mm, Mm
Gs^Fds, Gs^Fds, Gs^Fms, Gs^Fds, Gll^Fds, Gll, Gg, Ww, Hh, Hh, Re^Gvs, Re^Gvs, Re^Gvs, Re^Gvs, Re^Gvs, Re^Gvs, Re^Gvs, Re^Gvs, Gll^Fds, Gll^Fds, Gg, Re^Gvs, Gg, Gs, Gg, Hh, Gg, Hh, Mm, Mm, Hh, Gg, Gs, Hh, Hh, Gg, Gs, Hh, Mm, Mm, Mm
Gll^Fds, Gll^Fds, Gll^Fms, Gll^Fms, Gll^Fds, Gll, Gll^Fds, Ww, Hh^Fds, Hh^Fds, Gll^Fds, Re^Gvs, Re^Gvs, Re^Gvs, Gg^Eff, Gs^Eff, Gs^Eff, Gg^Eff, Gg, Gg, Gg^Efm, Gg, Gg, Gg, Gll^Fms, Gg, Hh, Hh, Mm, Hh, Gg, Gg, Cer, Hh, Hh, Gs, Hh, Mm, Mm, Mm, Mm
Gll^Fms, Gll^Fms, Gll^Fms, Gll^Fms, Gll, Gg, Ww, Ww, Ww, Ww, Ww, Gg, Gg, Gll^Fds, Ww, Gg, Ww, Ww, Ww, Gll^Efm, Gll, Gll^Fms, Gll^Fms, Gg, Hh^Fms, Hh^Fms, Hh, Mm, Hh, Gs, Gs, Cer, 4 Ker, Cer, Hh, Hh, Mm, Mm, Hh, Hh, Hh
Ww, Ww, Ww, Gll^Fms, Ww, Ww, Gll^Fds, Gll^Fds, Hh^Fds, Hh, Hh, Ww, Ww, Ww, Ww, Ww, Gs, Gg, Ww, Gll^Fds, Gll^Fms, Gll^Fms, Gll^Fds, Gg, Hh, Hh, Gg, Mm, Ww, Gg^Vh, Gg, Cer, Cer, Cer, Hh, Hh, Hh, Hh, Gs, Gs, Gg
Gll^Fds, Gll^Fds, Gll^Fds, Ww, Gll^Fds, Gll^Fds, Gll^Fds, Gll^Fds, Hh^Fds, Hh^Fds, Gg, Hh, Hh, Gg, Gll, Gg, Gll, Gg, Ww, Hh^Fds, Gll^Fds, Gg^Vh, Gll^Fds, Gg, Gll^Fds, Hh, Ww, Ww, Mm, Ww, Ww, Hh, Gs^Vh, Hh, Hh, Hh, Mm, Hh, Hh, Hh, Hh
Gll^Fds, Gll^Fds, Gll^Fms, Gll^Fds, Gll^Fms, Gll^Fds, Gll^Fds, Gll^Fds, Gll^Fds, Hh^Fds, Gll^Em, Gll^Fds, Gll^Fds, Gll, Gll, Gll^Fds, Gll^Fms, Gll^Fds, Gll^Fds, Ww, Ww, Ww, Ww, Gll, Ww, Ww, Hh, Mm, Mm, Hh, Hh, Hh, Gs, Gs, Hh, Hh, Mm, Mm, Mm, Hh, Hh
Gll^Fds, Gll^Fds, Gs^Fms, Gs^Fms, Gs^Fds, Gs^Fms, Gs^Fds, Gs^Vl, Gs^Fds, Gll^Fds, Gll^Fms, Gs^Fds, Gs^Fms, Gll^Fds, Gll^Fds, Gll^Fp, Gll^Fp, Gll^Fds, Gll^Fds, Gll^Fds, Gll, Hh^Fds, Gll^Fds, Ww, Hh, Hh, Mm, Mm, Mm, Mm, Mm, Hh, Hh, Gs, Gg, Hh, Hh, Mm, Mm, Mm, Mm
Gs^Fds, Gs^Fds, Gll^Fds, Gll^Fms, Gs^Fms, Gll^Fp, Gll^Fp, Gll^Fds, Gll^Fms, Gs^Fms, Gs^Fms, Gs^Fms, Gll^Fms, Gll^Fds, Gll^Fds, Gll^Fds, Gg^Vh, Gll^Fds, Gll^Fds, Gll, Gll^Fds, Gll^Fds, Hh^Fds, Hh^Fds, Mm, Mm, Mm, Mm, Mm, Mm, Mm, Mm, Hh, Gg, Hh, Hh, Hh, Mm, Mm, Mm, Mm
Gll^Fds, Gll^Fds, Gll^Fds, Gll^Fms, Gll^Fds, Gll^Fds, Gll^Fds, Gll^Fp, Gll^Fds, Gll^Fds, Gll^Fds, Gll^Fds, Gll^Fds, Gll^Fds, Gll^Fds, Gll^Fds, Gg, Gll^Fds, Gll^Fds, Gg, Gll^Fds, Hh^Fds, Hh^Fds, Hh^Fds, Mm, Mm, Mm, Mm, Mm, Mm, Mm, Mm, Hh, Gg, Hh, Hh, Hh, Mm, Mm, Mm, Mm
